NAME: large_room
WWWWWWWWWWWWWWWWWWWWWWWWWWWWWWWWWWWWWWWWWWWWWWWWWWWWWWWWWWWWWWWWWWWWWWWWWWWWWWWWWWWWW
W...................................................................................W
W...................................................................................W
W...................................................................................W
W...................................................................................W
W...................................................................................W
W...................................................................................W
W...................................................................................W
W..............................+....................................................W
W...................................................................................W
W...................................................................................W
W...................................................................................W
W...................................................................................W
W...................................................................................W
W...................................................................................W
W...................................................................................W
W...................................................................................W
W...................................................................................W
W...................................................................................W
W...................................................................................W
W...................................................................................W
W...................................................................................W
W.......................................+...........................................W
W...................................................................................W
W...................................................................................W
W...................................................................................W
W...................................................................................W
W...................................................................................W
W...................................................................................W
W...................................................................................W
W...................................................................................W
W...................................................................................W
W...................................................................................W
W...................................................................................W
W...................................................................................W
W...................................................................................W
W...................................................................................W
W...............+...................................................................W
W...................................................................................W
W...................................................................................W
W...................................................................................W
W...................................................................................W
W...................................................................................W
W...................................................................................W
W...................................................................................W
W...................................................................................W
WWWWWWWWWWWWWWWWWWWWWWWWWWWWWWWWWWWWWWWWWWWWWWWWWWWWWWWWWWWWWWWWWWWWWWWWWWWWWWWWWWWWW
