NAME: medium_room
WWWWWWWWWWWWWWWWWWWWWW
W....................W
W....................W
W....................W
W....................W
W....................W
W.........+..........W
W....................W
W....................W
W....................W
W....................W
W....................W
WWWWWWWWWWWWWWWWWWWWWW
