NAME: strange_room
   WWWWWWWWWWWWWWWWW
   W...............W
   W...............W
  W................W
  W.................W
 W...................W
W.....................W
W..........+..........W
W.....................W
W.....................W
 W...................W
 W............+......W
 W.................W
W.................W
WWWWWWWWWWWWWWWWWWW

